,dteday,mnth,season,casual,registered,cnt,weekday
0,2016-01-01,1,1,18,41,59,5
1,2016-01-02,1,1,32,77,109,6
2,2016-01-03,1,1,23,73,96,0
3,2016-01-04,1,1,6,101,107,1
4,2016-01-05,1,1,4,83,87,2
5,2016-01-06,1,1,2,109,111,3
6,2016-01-07,1,1,3,123,126,4
7,2016-01-08,1,1,8,107,115,5
8,2016-01-09,1,1,14,91,105,6
9,2016-01-10,1,1,13,89,102,0
10,2016-01-11,1,1,6,111,117,1
11,2016-01-12,1,1,5,125,130,2
12,2016-01-13,1,1,6,114,120,3
13,2016-01-14,1,1,7,148,155,4
14,2016-01-15,1,1,17,124,141,5
15,2016-01-16,1,1,27,84,111,6
16,2016-01-17,1,1,13,43,56,0
17,2016-01-18,1,1,4,48,52,1
18,2016-01-19,1,1,0,78,78,2
19,2016-01-20,1,1,1,78,79,3
20,2016-01-21,1,1,3,96,99,4
21,2016-01-22,1,1,0,54,54,5
22,2016-01-27,1,1,0,11,11,3
23,2016-01-28,1,1,0,41,41,4
24,2016-01-29,1,1,0,49,49,5
25,2016-01-30,1,1,4,55,59,6
26,2016-01-31,1,1,6,59,65,0
27,2016-02-01,2,1,1,77,78,1
28,2016-02-02,2,1,2,108,110,2
29,2016-02-03,2,1,1,77,78,3
30,2016-02-04,2,1,7,134,141,4
31,2016-02-05,2,1,7,124,131,5
32,2016-02-06,2,1,15,85,100,6
33,2016-02-07,2,1,10,82,92,0
34,2016-02-08,2,1,7,118,125,1
35,2016-02-09,2,1,1,87,88,2
36,2016-02-10,2,1,3,89,92,3
37,2016-02-11,2,1,2,88,90,4
38,2016-02-12,2,1,7,77,84,5
39,2016-02-13,2,1,1,27,28,6
40,2016-02-14,2,1,12,32,44,0
41,2016-02-15,2,1,1,6,7,1
42,2016-02-16,2,1,2,65,67,2
43,2016-02-17,2,1,5,108,113,3
44,2016-02-18,2,1,5,101,106,4
45,2016-02-19,2,1,9,113,122,5
46,2016-02-20,2,1,57,98,155,6
47,2016-02-21,2,1,16,75,91,0
48,2016-02-22,2,1,9,124,133,1
49,2016-02-23,2,1,0,49,49,2
50,2016-02-24,2,1,2,57,59,3
51,2016-02-25,2,1,1,125,126,4
52,2016-02-26,2,1,5,94,99,5
53,2016-02-27,2,1,22,100,122,6
54,2016-02-28,2,1,57,106,163,0
55,2016-02-29,2,1,16,145,161,1
56,2016-03-01,3,1,13,156,169,2
57,2016-03-02,3,1,5,96,101,3
58,2016-03-03,3,1,6,118,124,4
59,2016-03-04,3,1,3,100,103,5
60,2016-03-05,3,1,19,85,104,6
61,2016-03-06,3,1,33,76,109,0
62,2016-03-07,3,1,28,144,172,1
63,2016-03-08,3,1,28,179,207,2
64,2016-03-09,3,1,41,185,226,3
65,2016-03-10,3,1,27,171,198,4
66,2016-03-11,3,1,51,164,215,5
67,2016-03-12,3,1,83,136,219,6
68,2016-03-13,3,1,32,78,110,0
69,2016-03-14,3,1,15,143,158,1
70,2016-03-15,3,1,22,136,158,2
71,2016-03-16,3,1,85,179,264,3
72,2016-03-17,3,1,44,179,223,4
73,2016-03-18,3,1,47,160,207,5
74,2016-03-19,3,1,10,52,62,6
75,2016-03-20,3,1,13,73,86,0
76,2016-03-21,3,2,15,157,172,1
77,2016-03-22,3,2,23,149,172,2
78,2016-03-23,3,2,55,184,239,3
79,2016-03-24,3,2,71,190,261,4
80,2016-03-25,3,2,71,159,230,5
81,2016-03-26,3,2,129,155,284,6
82,2016-03-27,3,2,71,91,162,0
83,2016-03-28,3,2,27,135,162,1
84,2016-03-29,3,2,35,177,212,2
85,2016-03-30,3,2,41,197,238,3
86,2016-03-31,3,2,45,179,224,4
87,2016-04-01,4,2,50,173,223,5
88,2016-04-02,4,2,71,108,179,6
89,2016-04-03,4,2,20,94,114,0
90,2016-04-04,4,2,16,128,144,1
91,2016-04-05,4,2,12,137,149,2
92,2016-04-06,4,2,18,155,173,3
93,2016-04-07,4,2,11,90,101,4
94,2016-04-08,4,2,32,155,187,5
95,2016-04-09,4,2,18,63,81,6
96,2016-04-10,4,2,56,94,150,0
97,2016-04-11,4,2,28,165,193,1
98,2016-04-12,4,2,14,173,187,2
99,2016-04-13,4,2,19,163,182,3
100,2016-04-14,4,2,15,172,187,4
101,2016-04-15,4,2,42,181,223,5
102,2016-04-16,4,2,107,138,245,6
103,2016-04-17,4,2,104,126,230,0
104,2016-04-18,4,2,48,166,214,1
105,2016-04-19,4,2,42,184,226,2
106,2016-04-20,4,2,32,212,244,3
107,2016-04-21,4,2,38,214,252,4
108,2016-04-22,4,2,44,160,204,5
109,2016-04-23,4,2,52,116,168,6
110,2016-04-24,4,2,81,160,241,0
111,2016-04-25,4,2,58,178,236,1
112,2016-04-26,4,2,40,189,229,2
113,2016-04-27,4,2,15,149,164,3
114,2016-04-28,4,2,11,101,112,4
115,2016-04-29,4,2,23,161,184,5
116,2016-04-30,4,2,75,105,180,6
117,2016-05-01,5,2,19,81,100,0
118,2016-05-02,5,2,27,143,170,1
119,2016-05-03,5,2,17,154,171,2
120,2016-05-04,5,2,21,173,194,3
121,2016-05-05,5,2,14,165,179,4
122,2016-05-06,5,2,3,73,76,5
123,2016-05-07,5,2,47,129,176,6
124,2016-05-08,5,2,77,122,199,0
125,2016-05-09,5,2,21,174,195,1
126,2016-05-10,5,2,29,185,214,2
127,2016-05-11,5,2,15,142,157,3
128,2016-05-12,5,2,29,174,203,4
129,2016-05-13,5,2,38,153,191,5
130,2016-05-14,5,2,73,107,180,6
131,2016-05-15,5,2,51,106,157,0
132,2016-05-16,5,2,44,178,222,1
133,2016-05-17,5,2,4,109,113,2
134,2016-05-18,5,2,27,185,212,3
135,2016-05-19,5,2,39,225,264,4
136,2016-05-20,5,2,60,200,260,5
137,2016-05-21,5,2,13,72,85,6
138,2016-05-22,5,2,4,50,54,0
139,2016-05-23,5,2,26,137,163,1
140,2016-05-24,5,2,37,198,235,2
141,2016-05-25,5,2,54,200,254,3
142,2016-05-26,5,2,45,199,244,4
143,2016-05-27,5,2,65,184,249,5
144,2016-05-28,5,2,116,121,237,6
145,2016-05-29,5,2,92,79,171,0
146,2016-05-30,5,2,95,119,214,1
147,2016-05-31,5,2,46,183,229,2
148,2016-06-01,6,2,30,205,235,3
149,2016-06-02,6,2,32,208,240,4
150,2016-06-03,6,2,33,128,161,5
151,2016-06-04,6,2,78,166,244,6
152,2016-06-05,6,2,68,119,187,0
153,2016-06-06,6,2,46,212,258,1
154,2016-06-07,6,2,53,229,282,2
155,2016-06-08,6,2,41,216,257,3
156,2016-06-09,6,2,49,230,279,4
157,2016-06-10,6,2,60,192,252,5
158,2016-06-11,6,2,75,163,238,6
159,2016-06-12,6,2,81,151,232,0
160,2016-06-13,6,2,53,216,269,1
161,2016-06-14,6,2,42,244,286,2
162,2016-06-15,6,2,36,222,258,3
163,2016-06-16,6,2,30,172,202,4
164,2016-06-17,6,2,75,236,311,5
165,2016-06-18,6,2,110,167,277,6
166,2016-06-19,6,2,90,135,225,0
167,2016-06-20,6,2,63,202,265,1
168,2016-06-21,6,3,27,153,180,2
169,2016-06-22,6,3,52,203,255,3
170,2016-06-23,6,3,35,147,182,4
171,2016-06-24,6,3,38,190,228,5
172,2016-06-25,6,3,120,138,258,6
173,2016-06-26,6,3,114,138,252,0
174,2016-06-27,6,3,44,178,222,1
175,2016-06-28,6,3,32,180,212,2
176,2016-06-29,6,3,50,235,285,3
177,2016-06-30,6,3,50,238,288,4
178,2016-07-01,7,3,52,185,237,5
179,2016-07-02,7,3,158,134,292,6
180,2016-07-03,7,3,155,112,267,0
181,2016-07-04,7,3,82,65,147,1
182,2016-07-05,7,3,66,188,254,2
183,2016-07-06,7,3,56,189,245,3
184,2016-07-07,7,3,37,192,229,4
185,2016-07-08,7,3,43,184,227,5
186,2016-07-09,7,3,85,145,230,6
187,2016-07-10,7,3,94,185,279,0
188,2016-07-11,7,3,47,187,234,1
189,2016-07-12,7,3,40,217,257,2
190,2016-07-13,7,3,47,241,288,3
191,2016-07-14,7,3,52,187,239,4
192,2016-07-15,7,3,55,190,245,5
193,2016-07-16,7,3,156,131,287,6
194,2016-07-17,7,3,162,145,307,0
195,2016-07-18,7,3,39,149,188,1
196,2016-07-19,7,3,46,200,246,2
197,2016-07-20,7,3,62,211,273,3
198,2016-07-21,7,3,56,213,269,4
199,2016-07-22,7,3,58,199,257,5
200,2016-07-23,7,3,92,120,212,6
201,2016-07-24,7,3,59,110,169,0
202,2016-07-25,7,3,45,166,211,1
203,2016-07-26,7,3,39,183,222,2
204,2016-07-27,7,3,43,168,211,3
205,2016-07-28,7,3,41,168,209,4
206,2016-07-29,7,3,68,156,224,5
207,2016-07-30,7,3,71,106,177,6
208,2016-07-31,7,3,80,129,209,0
209,2016-08-01,8,3,54,209,263,1
210,2016-08-02,8,3,58,220,278,2
211,2016-08-03,8,3,63,200,263,3
212,2016-08-04,8,3,80,209,289,4
213,2016-08-05,8,3,69,198,267,5
214,2016-08-06,8,3,95,127,222,6
215,2016-08-07,8,3,97,120,217,0
216,2016-08-08,8,3,58,207,265,1
217,2016-08-09,8,3,50,187,237,2
218,2016-08-10,8,3,50,206,256,3
219,2016-08-11,8,3,48,186,234,4
220,2016-08-12,8,3,53,156,209,5
221,2016-08-13,8,3,70,107,177,6
222,2016-08-14,8,3,49,96,145,0
223,2016-08-15,8,3,39,141,180,1
224,2016-08-16,8,3,49,160,209,2
225,2016-08-17,8,3,44,166,210,3
226,2016-08-18,8,3,50,210,260,4
227,2016-08-19,8,3,58,194,252,5
228,2016-08-20,8,3,105,127,232,6
229,2016-08-21,8,3,49,104,153,0
230,2016-08-22,8,3,58,190,248,1
231,2016-08-23,8,3,44,236,280,2
232,2016-08-24,8,3,43,194,237,3
233,2016-08-25,8,3,35,212,247,4
234,2016-08-26,8,3,56,180,236,5
235,2016-08-27,8,3,83,132,215,6
236,2016-08-28,8,3,75,125,200,0
237,2016-08-29,8,3,36,190,226,1
238,2016-08-30,8,3,48,200,248,2
239,2016-08-31,8,3,40,203,243,3
240,2016-09-01,9,3,34,179,213,4
241,2016-09-02,9,3,61,186,247,5
242,2016-09-03,9,3,119,123,242,6
243,2016-09-04,9,3,132,101,233,0
244,2016-09-05,9,3,109,118,227,1
245,2016-09-06,9,3,41,200,241,2
246,2016-09-07,9,3,36,188,224,3
247,2016-09-08,9,3,37,173,210,4
248,2016-09-09,9,3,34,189,223,5
249,2016-09-10,9,3,72,127,199,6
250,2016-09-11,9,3,101,133,234,0
251,2016-09-12,9,3,43,208,251,1
252,2016-09-13,9,3,40,225,265,2
253,2016-09-14,9,3,41,210,251,3
254,2016-09-15,9,3,48,215,263,4
255,2016-09-16,9,3,57,209,266,5
256,2016-09-17,9,3,84,155,239,6
257,2016-09-18,9,3,64,141,205,0
258,2016-09-19,9,3,24,160,184,1
259,2016-09-20,9,3,39,199,238,2
260,2016-09-21,9,3,31,207,238,3
261,2016-09-22,9,3,48,232,280,4
262,2016-09-23,9,4,54,218,272,5
263,2016-09-24,9,4,110,165,275,6
264,2016-09-25,9,4,92,160,252,0
265,2016-09-26,9,4,31,175,206,1
266,2016-09-27,9,4,39,198,237,2
267,2016-09-28,9,4,24,149,173,3
268,2016-09-29,9,4,10,104,114,4
269,2016-09-30,9,4,19,157,176,5
270,2016-10-01,10,4,22,94,116,6
271,2016-10-02,10,4,64,150,214,0
272,2016-10-03,10,4,43,209,252,1
273,2016-10-04,10,4,36,192,228,2
274,2016-10-05,10,4,51,218,269,3
275,2016-10-06,10,4,48,204,252,4
276,2016-10-07,10,4,64,188,252,5
277,2016-10-08,10,4,29,73,102,6
278,2016-10-09,10,4,86,138,224,0
279,2016-10-10,10,4,75,143,218,1
280,2016-10-11,10,4,38,181,219,2
281,2016-10-12,10,4,48,198,246,3
282,2016-10-13,10,4,40,206,246,4
283,2016-10-14,10,4,47,193,240,5
284,2016-10-15,10,4,103,143,246,6
285,2016-10-16,10,4,66,140,206,0
286,2016-10-17,10,4,50,176,226,1
287,2016-10-18,10,4,37,204,241,2
288,2016-10-19,10,4,47,201,248,3
289,2016-10-20,10,4,36,195,231,4
290,2016-10-21,10,4,41,148,189,5
291,2016-10-22,10,4,69,129,198,6
292,2016-10-23,10,4,87,123,210,0
293,2016-10-24,10,4,34,201,235,1
294,2016-10-25,10,4,27,196,223,2
295,2016-10-26,10,4,25,174,199,3
296,2016-10-27,10,4,13,172,185,4
297,2016-10-28,10,4,33,199,232,5
298,2016-10-29,10,4,101,136,237,6
299,2016-10-30,10,4,70,121,191,0
300,2016-10-31,10,4,30,187,217,1
301,2016-11-01,11,4,32,200,232,2
302,2016-11-02,11,4,31,226,257,3
303,2016-11-03,11,4,49,212,261,4
304,2016-11-04,11,4,54,182,236,5
305,2016-11-05,11,4,82,154,236,6
306,2016-11-06,11,4,80,135,215,0
307,2016-11-07,11,4,33,168,201,1
308,2016-11-08,11,4,31,180,211,2
309,2016-11-09,11,4,18,136,154,3
310,2016-11-10,11,4,33,168,201,4
311,2016-11-11,11,4,62,156,218,5
312,2016-11-12,11,4,74,108,182,6
313,2016-11-13,11,4,54,99,153,0
314,2016-11-14,11,4,22,177,199,1
315,2016-11-15,11,4,30,160,190,2
316,2016-11-16,11,4,19,172,191,3
317,2016-11-17,11,4,22,179,201,4
318,2016-11-18,11,4,46,183,229,5
319,2016-11-19,11,4,48,93,141,6
320,2016-11-20,11,4,15,61,76,0
321,2016-11-21,11,4,9,129,138,1
322,2016-11-22,11,4,17,137,154,2
323,2016-11-23,11,4,24,147,171,3
324,2016-11-24,11,4,34,31,65,4
325,2016-11-25,11,4,62,52,114,5
326,2016-11-26,11,4,43,51,94,6
327,2016-11-27,11,4,23,70,93,0
328,2016-11-28,11,4,11,161,172,1
329,2016-11-29,11,4,10,125,135,2
330,2016-11-30,11,4,7,87,94,3
331,2016-12-01,12,4,15,161,176,4
332,2016-12-02,12,4,22,159,181,5
333,2016-12-03,12,4,27,97,124,6
334,2016-12-04,12,4,18,80,98,0
335,2016-12-05,12,4,14,158,172,1
336,2016-12-06,12,4,4,86,90,2
337,2016-12-07,12,4,20,137,157,3
338,2016-12-08,12,4,13,151,164,4
339,2016-12-09,12,4,7,123,130,5
340,2016-12-10,12,4,18,67,85,6
341,2016-12-11,12,4,18,67,85,0
342,2016-12-12,12,4,14,120,134,1
343,2016-12-13,12,4,5,130,135,2
344,2016-12-14,12,4,16,133,149,3
345,2016-12-15,12,4,2,90,92,4
346,2016-12-16,12,4,5,84,89,5
347,2016-12-17,12,4,8,36,44,6
348,2016-12-18,12,4,8,52,60,0
349,2016-12-19,12,4,12,123,135,1
350,2016-12-20,12,4,5,119,124,2
351,2016-12-21,12,4,6,121,127,3
352,2016-12-22,12,4,8,110,118,4
353,2016-12-23,12,4,7,74,81,5
354,2016-12-24,12,4,5,27,32,6
355,2016-12-25,12,4,21,23,44,0
356,2016-12-26,12,4,20,36,56,1
357,2016-12-27,12,4,25,89,114,2
358,2016-12-28,12,4,34,94,128,3
359,2016-12-29,12,4,22,67,89,4
360,2016-12-30,12,4,19,64,83,5
361,2016-12-31,12,4,14,44,58,6
