,dteday,mnth,season,casual,registered,cnt,weekday
0,2016-01-01,1,1,44,161,205,5
1,2016-01-02,1,1,53,254,307,6
2,2016-01-03,1,1,45,275,320,0
3,2016-01-04,1,1,22,402,424,1
4,2016-01-05,1,1,5,345,350,2
5,2016-01-06,1,1,18,485,503,3
6,2016-01-07,1,1,18,509,527,4
7,2016-01-08,1,1,21,539,560,5
8,2016-01-09,1,1,29,361,390,6
9,2016-01-10,1,1,15,279,294,0
10,2016-01-11,1,1,15,442,457,1
11,2016-01-12,1,1,12,491,503,2
12,2016-01-13,1,1,9,412,421,3
13,2016-01-14,1,1,10,462,472,4
14,2016-01-15,1,1,20,591,611,5
15,2016-01-16,1,1,41,342,383,6
16,2016-01-17,1,1,22,219,241,0
17,2016-01-18,1,1,11,238,249,1
18,2016-01-19,1,1,6,357,363,2
19,2016-01-20,1,1,4,455,459,3
20,2016-01-21,1,1,7,455,462,4
21,2016-01-22,1,1,7,402,409,5
22,2016-01-27,1,1,2,129,131,3
23,2016-01-28,1,1,3,236,239,4
24,2016-01-29,1,1,8,338,346,5
25,2016-01-30,1,1,18,214,232,6
26,2016-01-31,1,1,23,299,322,0
27,2016-02-01,2,1,10,495,505,1
28,2016-02-02,2,1,15,554,569,2
29,2016-02-03,2,1,3,279,282,3
30,2016-02-04,2,1,13,534,547,4
31,2016-02-05,2,1,3,247,250,5
32,2016-02-06,2,1,27,330,357,6
33,2016-02-07,2,1,31,308,339,0
34,2016-02-08,2,1,4,347,351,1
35,2016-02-09,2,1,11,460,471,2
36,2016-02-10,2,1,5,442,447,3
37,2016-02-11,2,1,3,368,371,4
38,2016-02-12,2,1,7,316,323,5
39,2016-02-13,2,1,4,139,143,6
40,2016-02-14,2,1,4,87,91,0
41,2016-02-15,2,1,2,115,117,1
42,2016-02-16,2,1,5,279,284,2
43,2016-02-17,2,1,9,479,488,3
44,2016-02-18,2,1,15,422,437,4
45,2016-02-19,2,1,12,404,416,5
46,2016-02-20,2,1,87,451,538,6
47,2016-02-21,2,1,56,320,376,0
48,2016-02-22,2,1,31,546,577,1
49,2016-02-23,2,1,10,346,356,2
50,2016-02-24,2,1,2,178,180,3
51,2016-02-25,2,1,10,480,490,4
52,2016-02-26,2,1,21,449,470,5
53,2016-02-27,2,1,40,320,360,6
54,2016-02-28,2,1,107,370,477,0
55,2016-02-29,2,1,22,536,558,1
56,2016-03-01,3,1,31,544,575,2
57,2016-03-02,3,1,16,534,550,3
58,2016-03-03,3,1,22,497,519,4
59,2016-03-04,3,1,9,351,360,5
60,2016-03-05,3,1,41,312,353,6
61,2016-03-06,3,1,41,317,358,0
62,2016-03-07,3,1,40,619,659,1
63,2016-03-08,3,1,39,671,710,2
64,2016-03-09,3,1,65,768,833,3
65,2016-03-10,3,1,65,772,837,4
66,2016-03-11,3,1,71,713,784,5
67,2016-03-12,3,1,178,507,685,6
68,2016-03-13,3,1,125,413,538,0
69,2016-03-14,3,1,11,190,201,1
70,2016-03-15,3,1,53,604,657,2
71,2016-03-16,3,1,63,644,707,3
72,2016-03-17,3,1,49,636,685,4
73,2016-03-18,3,1,56,648,704,5
74,2016-03-19,3,1,75,379,454,6
75,2016-03-20,3,1,38,317,355,0
76,2016-03-21,3,2,31,462,493,1
77,2016-03-22,3,2,50,605,655,2
78,2016-03-23,3,2,77,761,838,3
79,2016-03-24,3,2,61,674,735,4
80,2016-03-25,3,2,95,577,672,5
81,2016-03-26,3,2,146,397,543,6
82,2016-03-27,3,2,141,329,470,0
83,2016-03-28,3,2,20,385,405,1
84,2016-03-29,3,2,34,592,626,2
85,2016-03-30,3,2,60,633,693,3
86,2016-03-31,3,2,75,684,759,4
87,2016-04-01,4,2,79,649,728,5
88,2016-04-02,4,2,57,336,393,6
89,2016-04-03,4,2,28,269,297,0
90,2016-04-04,4,2,6,251,257,1
91,2016-04-05,4,2,20,472,492,2
92,2016-04-06,4,2,31,567,598,3
93,2016-04-07,4,2,25,590,615,4
94,2016-04-08,4,2,35,545,580,5
95,2016-04-09,4,2,20,238,258,6
96,2016-04-10,4,2,85,383,468,0
97,2016-04-11,4,2,47,591,638,1
98,2016-04-12,4,2,21,456,477,2
99,2016-04-13,4,2,49,708,757,3
100,2016-04-14,4,2,58,670,728,4
101,2016-04-15,4,2,74,694,768,5
102,2016-04-16,4,2,200,513,713,6
103,2016-04-17,4,2,227,574,801,0
104,2016-04-18,4,2,103,803,906,1
105,2016-04-19,4,2,72,839,911,2
106,2016-04-20,4,2,80,835,915,3
107,2016-04-21,4,2,105,796,901,4
108,2016-04-22,4,2,201,796,997,5
109,2016-04-23,4,2,181,448,629,6
110,2016-04-24,4,2,215,504,719,0
111,2016-04-25,4,2,99,764,863,1
112,2016-04-26,4,2,53,672,725,2
113,2016-04-27,4,2,102,722,824,3
114,2016-04-28,4,2,67,697,764,4
115,2016-04-29,4,2,61,613,674,5
116,2016-04-30,4,2,231,533,764,6
117,2016-05-01,5,2,20,205,225,0
118,2016-05-02,5,2,78,744,822,1
119,2016-05-03,5,2,24,410,434,2
120,2016-05-04,5,2,43,618,661,3
121,2016-05-05,5,2,60,747,807,4
122,2016-05-06,5,2,21,336,357,5
123,2016-05-07,5,2,149,471,620,6
124,2016-05-08,5,2,136,496,632,0
125,2016-05-09,5,2,100,849,949,1
126,2016-05-10,5,2,63,779,842,2
127,2016-05-11,5,2,105,904,1009,3
128,2016-05-12,5,2,143,972,1115,4
129,2016-05-13,5,2,50,612,662,5
130,2016-05-14,5,2,241,590,831,6
131,2016-05-15,5,2,130,467,597,0
132,2016-05-16,5,2,114,797,911,1
133,2016-05-17,5,2,86,789,875,2
134,2016-05-18,5,2,76,822,898,3
135,2016-05-19,5,2,102,908,1010,4
136,2016-05-20,5,2,138,936,1074,5
137,2016-05-21,5,2,113,532,645,6
138,2016-05-22,5,2,172,619,791,0
139,2016-05-23,5,2,91,873,964,1
140,2016-05-24,5,2,42,645,687,2
141,2016-05-25,5,2,90,988,1078,3
142,2016-05-26,5,2,75,934,1009,4
143,2016-05-27,5,2,93,840,933,5
144,2016-05-28,5,2,184,522,706,6
145,2016-05-29,5,2,262,491,753,0
146,2016-05-30,5,2,138,463,601,1
147,2016-05-31,5,2,70,887,957,2
148,2016-06-01,6,2,91,1068,1159,3
149,2016-06-02,6,2,90,1072,1162,4
150,2016-06-03,6,2,54,766,820,5
151,2016-06-04,6,2,188,620,808,6
152,2016-06-05,6,2,65,427,492,0
153,2016-06-06,6,2,84,919,1003,1
154,2016-06-07,6,2,61,932,993,2
155,2016-06-08,6,2,26,787,813,3
156,2016-06-09,6,2,79,977,1056,4
157,2016-06-10,6,2,99,918,1017,5
158,2016-06-11,6,2,172,580,752,6
159,2016-06-12,6,2,169,629,798,0
160,2016-06-13,6,2,77,974,1051,1
161,2016-06-14,6,2,67,1077,1144,2
162,2016-06-15,6,2,74,1046,1120,3
163,2016-06-16,6,2,52,861,913,4
164,2016-06-17,6,2,106,949,1055,5
165,2016-06-18,6,2,286,693,979,6
166,2016-06-19,6,2,259,643,902,0
167,2016-06-20,6,2,71,965,1036,1
168,2016-06-21,6,3,62,993,1055,2
169,2016-06-22,6,3,78,1004,1082,3
170,2016-06-23,6,3,64,975,1039,4
171,2016-06-24,6,3,99,1031,1130,5
172,2016-06-25,6,3,175,689,864,6
173,2016-06-26,6,3,194,664,858,0
174,2016-06-27,6,3,77,850,927,1
175,2016-06-28,6,3,57,943,1000,2
176,2016-06-29,6,3,76,1022,1098,3
177,2016-06-30,6,3,84,1032,1116,4
178,2016-07-01,7,3,73,690,763,5
179,2016-07-02,7,3,240,468,708,6
180,2016-07-03,7,3,281,432,713,0
181,2016-07-04,7,3,231,458,689,1
182,2016-07-05,7,3,83,772,855,2
183,2016-07-06,7,3,88,894,982,3
184,2016-07-07,7,3,68,905,973,4
185,2016-07-08,7,3,83,805,888,5
186,2016-07-09,7,3,164,589,753,6
187,2016-07-10,7,3,213,661,874,0
188,2016-07-11,7,3,118,985,1103,1
189,2016-07-12,7,3,109,1049,1158,2
190,2016-07-13,7,3,108,988,1096,3
191,2016-07-14,7,3,80,925,1005,4
192,2016-07-15,7,3,110,836,946,5
193,2016-07-16,7,3,181,555,736,6
194,2016-07-17,7,3,254,585,839,0
195,2016-07-18,7,3,78,802,880,1
196,2016-07-19,7,3,83,986,1069,2
197,2016-07-20,7,3,85,1008,1093,3
198,2016-07-21,7,3,110,1058,1168,4
199,2016-07-22,7,3,92,889,981,5
200,2016-07-23,7,3,172,549,721,6
201,2016-07-24,7,3,196,582,778,0
202,2016-07-25,7,3,74,639,713,1
203,2016-07-26,7,3,81,974,1055,2
204,2016-07-27,7,3,96,953,1049,3
205,2016-07-28,7,3,88,912,1000,4
206,2016-07-29,7,3,85,709,794,5
207,2016-07-30,7,3,138,423,561,6
208,2016-07-31,7,3,115,464,579,0
209,2016-08-01,8,3,103,839,942,1
210,2016-08-02,8,3,121,1008,1129,2
211,2016-08-03,8,3,154,988,1142,3
212,2016-08-04,8,3,107,1018,1125,4
213,2016-08-05,8,3,119,920,1039,5
214,2016-08-06,8,3,259,670,929,6
215,2016-08-07,8,3,274,627,901,0
216,2016-08-08,8,3,111,903,1014,1
217,2016-08-09,8,3,123,976,1099,2
218,2016-08-10,8,3,104,906,1010,3
219,2016-08-11,8,3,100,897,997,4
220,2016-08-12,8,3,89,784,873,5
221,2016-08-13,8,3,223,545,768,6
222,2016-08-14,8,3,159,525,684,0
223,2016-08-15,8,3,120,837,957,1
224,2016-08-16,8,3,83,859,942,2
225,2016-08-17,8,3,97,967,1064,3
226,2016-08-18,8,3,107,973,1080,4
227,2016-08-19,8,3,134,913,1047,5
228,2016-08-20,8,3,279,646,925,6
229,2016-08-21,8,3,178,509,687,0
230,2016-08-22,8,3,123,966,1089,1
231,2016-08-23,8,3,125,1070,1195,2
232,2016-08-24,8,3,107,996,1103,3
233,2016-08-25,8,3,89,1008,1097,4
234,2016-08-26,8,3,130,929,1059,5
235,2016-08-27,8,3,250,712,962,6
236,2016-08-28,8,3,246,654,900,0
237,2016-08-29,8,3,112,990,1102,1
238,2016-08-30,8,3,88,1059,1147,2
239,2016-08-31,8,3,98,998,1096,3
240,2016-09-01,9,3,61,676,737,4
241,2016-09-02,9,3,150,929,1079,5
242,2016-09-03,9,3,264,590,854,6
243,2016-09-04,9,3,383,531,914,0
244,2016-09-05,9,3,278,632,910,1
245,2016-09-06,9,3,84,965,1049,2
246,2016-09-07,9,3,87,1160,1247,3
247,2016-09-08,9,3,91,1108,1199,4
248,2016-09-09,9,3,108,1035,1143,5
249,2016-09-10,9,3,231,752,983,6
250,2016-09-11,9,3,257,784,1041,0
251,2016-09-12,9,3,128,1098,1226,1
252,2016-09-13,9,3,95,1198,1293,2
253,2016-09-14,9,3,100,1037,1137,3
254,2016-09-15,9,3,95,1186,1281,4
255,2016-09-16,9,3,136,1162,1298,5
256,2016-09-17,9,3,305,888,1193,6
257,2016-09-18,9,3,228,819,1047,0
258,2016-09-19,9,3,37,649,686,1
259,2016-09-20,9,3,101,1204,1305,2
260,2016-09-21,9,3,113,1185,1298,3
261,2016-09-22,9,3,105,1187,1292,4
262,2016-09-23,9,4,135,1145,1280,5
263,2016-09-24,9,4,211,806,1017,6
264,2016-09-25,9,4,273,824,1097,0
265,2016-09-26,9,4,104,1112,1216,1
266,2016-09-27,9,4,93,1143,1236,2
267,2016-09-28,9,4,70,1090,1160,3
268,2016-09-29,9,4,54,993,1047,4
269,2016-09-30,9,4,16,418,434,5
270,2016-10-01,10,4,107,696,803,6
271,2016-10-02,10,4,129,702,831,0
272,2016-10-03,10,4,103,1008,1111,1
273,2016-10-04,10,4,91,1160,1251,2
274,2016-10-05,10,4,86,1139,1225,3
275,2016-10-06,10,4,123,1264,1387,4
276,2016-10-07,10,4,138,1229,1367,5
277,2016-10-08,10,4,109,546,655,6
278,2016-10-09,10,4,36,401,437,0
279,2016-10-10,10,4,114,903,1017,1
280,2016-10-11,10,4,85,1059,1144,2
281,2016-10-12,10,4,72,1077,1149,3
282,2016-10-13,10,4,86,1189,1275,4
283,2016-10-14,10,4,102,1122,1224,5
284,2016-10-15,10,4,204,813,1017,6
285,2016-10-16,10,4,209,752,961,0
286,2016-10-17,10,4,98,1155,1253,1
287,2016-10-18,10,4,104,1232,1336,2
288,2016-10-19,10,4,104,1242,1346,3
289,2016-10-20,10,4,92,1214,1306,4
290,2016-10-21,10,4,38,782,820,5
291,2016-10-22,10,4,47,481,528,6
292,2016-10-23,10,4,132,667,799,0
293,2016-10-24,10,4,78,985,1063,1
294,2016-10-25,10,4,57,1018,1075,2
295,2016-10-26,10,4,57,1007,1064,3
296,2016-10-27,10,4,6,462,468,4
297,2016-10-28,10,4,37,890,927,5
298,2016-10-29,10,4,126,722,848,6
299,2016-10-30,10,4,155,657,812,0
300,2016-10-31,10,4,81,939,1020,1
301,2016-11-01,11,4,50,1068,1118,2
302,2016-11-02,11,4,91,1181,1272,3
303,2016-11-03,11,4,64,1181,1245,4
304,2016-11-04,11,4,89,1057,1146,5
305,2016-11-05,11,4,219,772,991,6
306,2016-11-06,11,4,120,677,797,0
307,2016-11-07,11,4,59,904,963,1
308,2016-11-08,11,4,81,1131,1212,2
309,2016-11-09,11,4,15,741,756,3
310,2016-11-10,11,4,48,986,1034,4
311,2016-11-11,11,4,74,882,956,5
312,2016-11-12,11,4,107,598,705,6
313,2016-11-13,11,4,117,664,781,0
314,2016-11-14,11,4,57,937,994,1
315,2016-11-15,11,4,13,465,478,2
316,2016-11-16,11,4,44,992,1036,3
317,2016-11-17,11,4,39,1059,1098,4
318,2016-11-18,11,4,64,999,1063,5
319,2016-11-19,11,4,103,690,793,6
320,2016-11-20,11,4,24,361,385,0
321,2016-11-21,11,4,11,648,659,1
322,2016-11-22,11,4,19,684,703,2
323,2016-11-23,11,4,25,677,702,3
324,2016-11-24,11,4,37,212,249,4
325,2016-11-25,11,4,63,350,413,5
326,2016-11-26,11,4,80,407,487,6
327,2016-11-27,11,4,56,480,536,0
328,2016-11-28,11,4,26,780,806,1
329,2016-11-29,11,4,2,263,265,2
330,2016-11-30,11,4,2,503,505,3
331,2016-12-01,12,4,22,833,855,4
332,2016-12-02,12,4,31,779,810,5
333,2016-12-03,12,4,49,571,620,6
334,2016-12-04,12,4,52,502,554,0
335,2016-12-05,12,4,26,714,740,1
336,2016-12-06,12,4,11,662,673,2
337,2016-12-07,12,4,19,728,747,3
338,2016-12-08,12,4,11,787,798,4
339,2016-12-09,12,4,14,636,650,5
340,2016-12-10,12,4,21,461,482,6
341,2016-12-11,12,4,12,330,342,0
342,2016-12-12,12,4,5,541,546,1
343,2016-12-13,12,4,14,758,772,2
344,2016-12-14,12,4,18,725,743,3
345,2016-12-15,12,4,2,477,479,4
346,2016-12-16,12,4,5,493,498,5
347,2016-12-17,12,4,2,135,137,6
348,2016-12-18,12,4,6,324,330,0
349,2016-12-19,12,4,9,493,502,1
350,2016-12-20,12,4,10,582,592,2
351,2016-12-21,12,4,13,614,627,3
352,2016-12-22,12,4,18,565,583,4
353,2016-12-23,12,4,23,516,539,5
354,2016-12-24,12,4,3,161,164,6
355,2016-12-25,12,4,61,158,219,0
356,2016-12-26,12,4,32,183,215,1
357,2016-12-27,12,4,58,485,543,2
358,2016-12-28,12,4,45,391,436,3
359,2016-12-29,12,4,7,230,237,4
360,2016-12-30,12,4,48,399,447,5
361,2016-12-31,12,4,39,267,306,6
